8.ox
.o......
........
....o...
.ooo....
......o.
........
.....o..
..o.....
